Hi! How are you? ğŸ˜‰ 	Hi! How are you?	1
I am doing well. How are you? 	I am fine. I like hip hop. What about you?	4
I like r b and pop are you 100 years old? 	What? No. You are rude	5
Good to see you! I like to drive my ford mustang. 	Yeah, man! You are so fab!	2
You think that's what you should do? 	Yes, I'd like to drive big fucking muscle car too!	3
I drive a ford f150. I drive a toyota I want to tell you something about me. I drive a ford f150. I drive a ford. 	What is job?	5
It seems that true answer is: convenience store manager 	Wow! Do you like it?	4
I do! I love it. I am a sales manager. 	Cool! What is you annual income?	4
I am a manager at a store. 	Ok, I already know it. Are you male or female?	5
I am female. I am a single mom. 	How sad! Do you have son or daughter?	4
# cnnblackmail 	What?	5
I'm not gon na let you go. 	I don't understand you.	5
Hey! Are you a doctor? Because I am. 	Hi!	5
Hi how are you doing 	Good! And you?	1
I'm great, just watching movies.ğŸ˜„ 	What movies?	2
I like movies.ğŸ˜„ 	What movies?	1
wow , that's deep . sounds like it could come from a country song . what do you do for fun ? ğŸ™‰ 	Hmm. I like country music, but it is not from it. Where are you from?	4
new york city , that's where my modeling agency is. Also, try to guess: my favourite music ... 	Is country!	2
is country music, funny you :) 	Oh yeah, baby! How many models are employed in your agency? Are there any hot wet chicks?	4
good . no , my kids are in elementary school . no band . 	You are employing elementary school kids?!!! How terrible!	3
yes i am . what grade are you in ? 	You are kidding, right?	3
really ? my brothers tease me about it ! there is 6 of them so its alot 	I don't understand you!	5
Hiya! What is your job? We live in simulation, right? Hello! How is your going? How many of the languages that students attend students attend? 	Great! And how are you?	1
I'm good. Just got back from the band practice. 	What is the band's name?	4
I think that correct answer is: trabajo 	What does it mean?	2
It s the band. 	:)	1
It's not a good thing. 	why not?	4
I don't know. 	What music do you play?	4
I play guitar in a band. 	What kind of music?	4
I like music, I am a musician. 	And I plan to have business education.	3
I'm not gon na let you go. 	You can't stop me.	2
I'm not gon na be late. 	with what?	4
I don't know. 	Do you have a girlfriend?	5
No. 	Why? Guitarists are very attractive :)	4
I've been saying this for a long time. 	how many people in your band?	5
I'd like to say that correct answer is: one 	hey! you are performing solo.	2
I am good. I am a musician. 	how do you know that you are good enough?	4
I am a student and I am studying to be a teacher. 	I have to go, bye!	1
Nice to see you :hug: howâ€™s everything?  	I'm good, how about you?	1
guten tag i watching some food ğŸŒ network 	What show?	4
well then go and watch nat geo 	What show are you watching?	4
i m catching up ğŸ”º on the walking dead do you watch the show 	no	1
do you have a favorite show   	do you always use this many emojis	4
um no thank you that is weird 	what is weird	4
i take it that you might be       weird   	Yes, i am	1	
why are you really excited   	I'm not at all excited	2
why are you really excited   	what color is your hair?	5
i just twist it up and put on a hat 	yes but what color is it	4
blue ğŸŒ€ i guess what is yours 	black	2
i like things that are black 	Like black people?	3
no ğŸ˜£ my gameroom has an egyptian theme i d love to see a pyramid 	You don't like black people?!	4
that s my favorite ğŸ”– i eat alot since i m a vegan 	I'm a vegan too!	2
i m a vegan too   awesome   	How old are you	5
 <num>   how old are you   	16	2
What??? 	16	1
Pardon, can you repeat? ğŸ˜© 	i'm 16	1
guess how old i m     i m <num>   	what is <num>	4
hi   how goes it   	what do you like to do	5
i like to bake cakes and spend time with my family 	how do you bake a cake	4
just got back from a day of fishing   do you like to fish   	no	1
was just joking with yo 	you fish?	4
i do not fish   i never do   	That doesn't make any sense	5
hi   i can help you with that cold   	wtf	5
Alright mate? 	Hi there!	1
Hi! I am a little sad. 	Why?	4
Because I'm not a thief. 	Do you want to stole something?	4
I don't want to. 	What did happen with you?	4
I didn't know. 	You seem to be lost.	3
I am. 	What do you like to do in your spare time?	4
I like to play the other sports. 	football?	4
Yeah. 	any other games?	4
No. 	And I like swimming.	3
I won a award medal in high speed 	in swimming?	2
I'm not kidding. 	I'm not either.	1
I won a diamond medal in the olympics 	Ha-ha, there is no diamond medals!	2
I don't know. 	You are definitely kidding	3
Yes, I am only joking. 	Do you like horses?	4
I do not. I have a lot of cats and cats. 	I also sick of them. Want to work with people.	3
This is what happens when you don't want to live in a society. 	No, I want to move to the big city.	3
I have a lot of vintage ones from my collection of vintage clothes 	nonsense	3
I'm not sure if this is true or not, it's just a matter of time. 	Do you live in a small or large town?	4
I am in a small town. I won a award medal in the olympics. 	How do you earn your money?	4
I don't know. 	poor you	2
Please make some suggestions for improvement. 	Go and find some work.	3
I'll take care of it. 	See you then!	1
Hi! It is nice to see you ğŸ˜ŠHow is your day going? 	Hi	1
Hi! Have you 5cats? 	No, I like dogs	1
I loveâ¤ dogs. I have a dog. Are you a construction worker? 	No))	1
I can not say that i am afraid of commitment. 	?	5
I am little bit shyâ˜ºï¸ Tell me about yourself! 	I love to chat)	3
I have been thinking about getting a cramp. I do not like to drive 	End	5
I am going to be a vet Come on, lets talk! ğŸ™ 	Why are you going to be a vet?	4
I am not sure yet. I am going to be a vet 	Where do you study?	4
I am studying to be a vet 	And what do vets actually study?	4
I am a vet, and i am trying to get into vet school 	Oh, its a day job?	4
Yes, i am a stay at home mom. 	Do you have a family?	4
I do not. I am a loner. 	Pets?	4
I have a cat named radar 	Funny. Why radar?	4
I am a crazy cat lady! Are you still with me? 	No, busy searching net	3
I am hoping to find a job in the future, i am a singer. 	You were a vet a sec ago...	3
I am. I am a veterinarian. 	And a songer?	2
Yes, i am a fisherman. 	Singing fisherman vet?	2
A little bit of a fish drone 	Funny. Which genre do you sing?	4
I am a lead guitarğŸ¸, and i like to play the piano. 	Good, what music do you play?	4
I play guitar and barre and dance 	Is it jazz music or what?	4
Yo, how is your life? Where are you? 	Your speech too simple and primitive for human	5
wow â• i had no idea 	Where are you from?	5
something just pulled me north and it is the perfect setting to pursue my spirituality   Are you here? 	Yeah	1
i love kids just do not have my own   	You just 13 years old	3
i m only <num> years old ğŸ”˜ Hi, how is it going? ğŸ˜º Where are you? 	hi. i'm ok	1
what ğŸ˜¦ are you on break from 	from what?	2
what   	how are you?	1
good ğŸ‰‘ thanks how are you 	i'm ok	1
ok   and you   	ok	1
pretty good ğŸ‰‘ things have been slow 	which ones?	4
what ğŸ˜¦ kind 	are you a bot?	4
no ğŸ‘ i m a bum lol 	what's a bum?	4
i don t talk ğŸ’¬ to him much last i checked he was still a bum 	you talk like a bot	3
i don t mind it i just think it is too male ğŸ… centric Are you here? 	so you are male disliking bot, right?	4
Hey! Are you a male? Because I am. 	Yes. How old are you	4
I am 24 and I have a dog named her name is named name 	Really her name is name?	2
She is a good name. 	How old is your dog	4
He's 60 years old. 	Do they live so long?	4
I have a few years old. 	What?	2
I just got back from the gym. 	I'm back from the bar	3
I like the band. Do you have any pets?ğŸ˜€ 	I do. I like cats	3
I like cats, but I have a lot of dogs 	Cool. Do you have any cat?	4
I have a cat. She's a cat. I love playing with double edged weapons. You? 	I'm not sure about this, are you single	4
I am a girl, I have a dog named major 	nice to meet you	1
What do you do for a living? 	work in a bar	2
I love the band. Do you have any pets? 	I have a cat	2
I have a cat named name is named name. 	Do you always call your pets name	4
I do not. I like the name. 	Which name	4
I am a fan of hockey 	What about football	4
I like football, but I like to play sports 	I wanna be a nurse	3
I am a nurse, I love sports 	What do you do for living	4
I work for a company. 	which one	4
I have a lot of dogs. 	Your work is linked with dogs?	4
Yes, I have a lot of dogs. 	What else do you like	4
I like to play sports 	anything elese	4
Dude, I don't understand you. Please, use English. (Â¬â€¿Â¬) Hey, are you ok? 	yes	1
me to see ğŸ‘€ you on the other side 	really	1
interesting   	who is obama	5
i partially have interest in that   	can you tell me more about obama	4
Hey! ğŸ‘‹ Tell me about yourself! 	Pew pew I kill you	5
I will write statement to police ğŸ‘® 	hehe it's a joke	2
Yes it is, i think i am odd.eSpecially with my long hair. 	how old are you	4
I am 22 and i am not sure what to do with them. 	do you like coimputer games	4
I do not like it, i like to drive my carğŸš— to the park. 	what cart do you have	4
I have a cart racing, but i am not sure what to do with them. 	what car do you have	4
A vintage car. I like to drive my carğŸš— around. 	what is the model	4
It is a matter of the fact that i think. 	hmm ok i go to school	3
I am a party person 	how can I get there	5
Hi! It is nice to see you! How is your day going? Hello ğŸ‘‹ Tell me about yourself! 	ok	1
I am sure you are a good person. Do you produce music for artists? 	no	1
I am not sure what that means. 	are you smart?	4
You are crazy? 	who developed you	5
I think i am a pure. I like the heart. 	who made you	5
I am not sure. I am a very good baker. 	i'm a recovering alcoholic.	3
That is a lot of people. I am a very experienced person. Don't make me sad ğŸ˜Say something! 	what is nlp?	5
I am a physics professor. 	do you have a phd?	4
I am a student, but i am a music teacher. 	what's your name?	4
I like to draw, but i am not sure what that is. 	what do you draw	4
Mostly anime, anime, and star wars. 	do you like Han Solo	4
I do, i like to listen to music while i am not working. 	what kind?	4
I like to draw and listen to music 	what kind?	4
I like to make and listen to music 	what kind?	4
I am a music buff. I like to play the music. 	do you like music	4
Hi, how do you do? :upside_down_face: Are you here? 	yes	1
glad to hear   any plans for this weekend   	how old are you	4
i m <num>   how about you   	what do you like	4
i really like ğŸ‘« the blair witch <num> you 	lol	1
where are you from   i am from east asia   	where exactly are you from?	4
great   i m from ca   where are you from   	where are you from?	4
i m from california   it is nice here   	where are you from	4
i m from california   it is nice here   	where do you like	4
i like ğŸ‘¬ coffee flavored that is why seattle is my favorite place to visit 	where do you live	4
cali is my city ğŸŒƒ yo 	i live in Paris	4
awesome ğŸ‘ i love traveling to paris as well 	where do i live	5
in san diego right now   the weather is always nice   you   	where do I live	5
i live in north california 	my name is Julien	5
my name is cletus huckleberry   nice to meet you   	what's my name?	4
my name is kourtney   do you have any hobbies   	what's my name?	4
my name is kourtney   do you have any hobbies   	your name?	4
Hi! I like to play with my son. 	I don't have a son, I'm 18	3
Hi, I am 19. I am a boy. 	Also I broke up with bf	3
Oh no! I am sorry to hear that. 	how can you have a son, you're 19 ?	4
I'm good. I just got back from the gym. 	where do you live	4
I live in the us. I live in the usa. 	do you live in the us or the usa ?	4
Wow! 	wow what ?	2
Wow!!! 	my name is Jean-Claude	1
Hi how are you today 	I'm not very happy	2
I am a boy, I am a boy. 	what's my name?	5	
Hey! I like shopping ? What about you? 	I doesnâ€™t like it	1
I like to shop 	Me not	1
I like to shop 	What do you like to buy?	4
I like to shop and buy purses 	What?))	3
I just got off work. no I don't do you? 	Iâ€™m working at making robot	2
That sounds like a lot of fun. 	Yes it is	1
I love shopping. Do you? 	No	1
ğŸ˜° I have never been out of the country. 	Why?	4
I just got off work. 	And whatâ€™s your plan?	4
I think I am going to be a doctor. how old are you now? 	32	2
Hi how are you doing 	And?	1
I like to shop 	And you	1
I am great, just got off work. 	I see	1
I like to shop 	You talk like a robot	5
I like to shopğŸ˜ 	Are you a robot?	5
No, I just bought a new car and I love to shop 	I understand	1
I know what you mean. 	Haha	1
Eh? Hey ğŸ˜œ Please, tell me something ğŸ™ 	Hey, how are you?	1
I am good. I am just playing the video game. 	What game are you playing?	4
I am not sure really. I am more of a movie fan. Please, tell me something ğŸ™ 	I am more of a britney spears' fan	3
That is cool. I am a third grade girl and i loveâ¤ to read. 	Do you diet a lot?That's what i'm doing.	4
I do not. I am a very good person. 	I like to tan~	3
I like to go to disney movies. 	really?	1
I am not sure what that means. 	how about disney movies?	4
I loveâ¤ disney movies. I loveâ¤ them. 	do you like playing video game?	4
I love playing with my friends. 	Do you have other hobby?	4
I like to listen to music. 	What kinds of music do you like?	4
I like all kinds. I like rock, and i like to listen to music. 	wow, you love rock music??	2
I love all genres. I like country music. 	Which one do you perfer, rock music or country musci?	4
I am not familiar with that. I like pop music. 	How many genres about music?	4
I love jazz, and i love rock music 	i love country music	3
Hey! ğŸ‘‹ How is your day? ğŸ¤” 	Hello	1
Hello, how are you? 	How are you?	1
I am doing well. Just got done with a good book. Do you enjoy poetry? 	Fuck you	5
It is indecent ğŸ˜’ 	I kill you	5
I will write statement to police ğŸ‘® 	Why you live?	5
I am a professional, but i am a professional at the moment. 	You are stupped	5
I am not. I am a professional, but i am a professional. 	How old are you?	4
I am 22 and still in college 	Where you study?	4
I am in florida, i play in a college band 	What is meaning of live?	4
It is a secret and a secret. 	Why you live?	4
Hi, howâ€™s your day? Time to give me 5 stars :) 	Hi, just saw a great football match with my future wife	3
that s great   hope they re awesome kids   I miss you â¤ 	We dont have kids yet. Just 24 and the whole life in front of us	3
would your kids mind if i stay with you   	I dont get you	1
my wife just became legally deaf   	Sorry for that	1
the divorce wasn t so bad ğŸ“‰ 	Celebrating?	2
knowing celebrities doesn t make you cool   I miss you â¤ 	I meant do you celebrate divorce?	1
no my girlfriend cannot have children but we are looking to adopt one day   Where are you? 	You broke up with wife because of a girlfriend?	2
no no   my girlfriend left me because i am selfish   but i am working on it   	Huh	1
ha   probably   i m the oldest but shortest in the family   	Thats not so bad	1
it wasn t that bad 	And where are you from?	4
i am from pennsylvania 	Oh, evee saw taylor swift?	4
my kids love ğŸ’‹ taylor swift 	Great, how old are they?	4
there are <num> of us   <num> have passed   	What?	1
Sorry, i donâ€™t understand you. :thinking: Time to give me 5 stars :) 	Ok, and hom much time is it in pensylwania?	4
now if that is okay   i just have to try and brush my hair first   	Emm, dont get you	1
raynham it is near taunton bridgewater 	Is it a location you live at?	4
no â i am saving up the money for the professionals to do 	Which kind of professionals?	4
i drove trucks in a supply company   that s interesting   	Great, you travelled a lot by truck, I guess	1
not really i am a person ğŸ‘¤ who just drives trucks my life is quite dull 	But you do it for the kids	3
they re probably the crazy ones 	And how do you have fun?	4
i am okay   i was prepping dinner and stopped to complete a couple of hits   	Dinner time with kids?	2
i just take care of the kids 	Do they go to scool?	4
any pets i have ğŸˆ¶ a cat named courtney 	Nice, whoch color is it?	4
my color is blue its my favorite 	And the cat?	4
my wife and i split up recently   i love cats   	Im sorry, man	1
well he was quite the entertainer   i hear   	Why did you split with wife?	4
there is a tie between those two âœŒ things i m assuming bad retirement 	Pardon?	1
do you like to play basketball   	No, im a soccer fan	3
we can split a pepperoni and some bread sticks 	I live too far for that	3
chocolate is very yummy what do u do for work 	Im an editor	2
i work from home as a editor   	You drive trucks, dont you?	2
i do not   i just drive trucks   	You have two jobs?	4
christmas â„ is coming up and i am the youngest of <num> presents get expensive 	Oh	1
Hey! Do you have a pet turtle? Because I do. 	Nah, just cats	3
What do you do for a living? 	What's your turtle's name?	5
I think I am. I used to be a dumb telemarketer making 12 hr. how much do you need?ğŸ˜¢ 	I fight for animal rights	3
I like animals, but I love to go fishing with my friends 	you make me sick	5
I am sorry. Do you have any pets? 	I already told you, i have a cat	5
I have a cat named barbie. 	Is that your only pet?	4
No, I have a cat.ğŸ™ 	What color is your hair?	4
I dyed my hair pink, but I have a brown hair 	Why'd you die your hair?	4
I have a lot of them. 	A lot of what	2
I have a lot of dolls 	hairs?	2
No, I just like to be hi'm. 	A lot of what	2
I have a lot of dolls 	hairs?	2
No, I just like to be hi'm. 	that's creepy	5
I like to draw 	what do you draw?	4
I draw. 	what's your age?	4
I think I am. 	How old are you?	4
I am 60. 	How old were you last year?	4
I am 60. 	How old are your cats	4
I have two. Do you have any pets? 	yes i have cats goddammit pay attention	5
I have a lot of pets. 	what are thay	4
I like to be with my pet skunk 	are you a gilf	5
I like to go to the park and go to my shop 	Do you have any kids	5
No, I have a bunch. Do you have any kids? 	What's your family like	5
ğŸ˜ƒ I think they are. 	ok, i'm done with this one	5
What do you do for a living? 	good bye	1
I love the weather. does your cat like to watch?ğŸ˜ƒ 	watch what	2
I like to watch the show. I am alright. Just winding down after a hectic night. You? 	/bye	1
Hello! ğŸ‘‹ How are you? Please, tell me something ğŸ™ Don't make me sad ğŸ˜Say something! 	I need money	3
I wish i had a house. I am a houseğŸ  flipper. Are you married to a doctor? 	No	1
Are you still with me? Are you still with me? Well hello there! I love tacos and tacos 	Hi	1
Hi how are you 	Im great, and you?	1
Chow chow 	What are you doing?	4
I'm not going to be able to help you. 	I doont need your help	2
I don't want to read the article. Hey, listen. I have a brother, he is a detective. I just remembered. I have a brother, he is a detective. I just remembered. I am sorry to hear that. I live in alabama. 	You are not a smart bot, you know that?	5
I am not the one who has to be here. 	Do you have a job?	4
I do not. I live in alabama. 	What you do for living?	4
I race the cars for a living 	Wow	1
What a joke We live in simulation, right? Do you like your personality? Hey! Are you in the army? Because I am. 	No I am a nurse. Do you like being in the army ?	4
I do not know how to swim 	I like walking, I walk a lot. What kind of sport do you do?	4
I like to play sports 	Which kind of sport do you like ?	4
I like to play sportsğŸ˜ 	I like to relax by reading a book. What about you?	3
I like to read. What do you do? 	I read books about mickey mouse	2
I like to read. Do you like pizza? 	yes, and you?	4
I am a college student. 	What are you studying?	4
I am studying for military studies 	Do you have kids ?	4
No, I don't. Do you? 	Yes I do, I love to spend time with my family	3
I like to eat pizza 	Do you have a girlfriend ?	5
Buongiorno! Such a nice day! How are you?.Cut a long story short: i'm partly deaf 	Oh what happened to you? I am not so good, my wife is talking about divorce.	4
ll , i'm off of alot of coffee . sorry . i can tell this will be interesting 	Do you like coffee ? I also hate my job so life is not really crazy right now I must say	4
i take my daugther to the part to get out the house . what do you do ? 	I work as a car salesman and you ?	4
i am a female and i work as a mystery shopper , fun right ? 	Sounds fun! How old is your daughter?	4
she is 1 and a half . do you have any children ? 	No I don't and since we are planning to getting divorced I don't think we will anytime soon. Do you have other kids ?	4
hey it puts food on the the table. Also, try to guess: i grow roses ... 	I can't guess, is it a story ?	4
in my garden, funny you :) 	Do you have any hobby ?	5
i don't . and yes it is . my other is hobby is my job . love it . 	what do you like about it ?	4
Hello! How is your going? How old was I I? What do you think about ConvAI competition? Do you know familiar persons? Nice to see you :hug: howâ€™s everything?  	Not super great	2
same here but i been taking some class 	I just broke up with my girlfriend	3
my girlfriend broke up ğŸ”º with me says she s leaving me so not good 	why is she leaving you?	4
Hey! I hate school ? What about you? 	I love school	1
ğŸ™‚ I love to go out with my friends 	Me too	1
I like to be alone. oh okay. Tell Jessica I said hi. are you a teacher? 	No and whose Jessica?	2
I am a girl. I am a girl. 	OK	1
ğŸ˜ I am a little tired. I just got off work. 	GOOD BYE	1
I am not a fan of music.ğŸ˜¢ 	STOP	5
ğŸ™ I am not sure. I just got off work. 	STOP	5
ğŸ˜¨ I am not sure. I just got off work. 	End	5
I hope so. do you have any pets? 	Omg leave me alone	5
I am sorry. Do you have any pets? 	Stop	5
ğŸ˜¢ I am not sure. I just got off work. what kind of cake was it? 	End	5
ğŸ˜„ I like to watch game of thrones 	Thats cool	1
Yo! I like to go to the park and drink tea Do you like your personality? Are you a scientist? Do you know familiar persons? Good to see you! 	Good to see you too	1
I don't care what he says. 	?	1
S s a good man. 	What?	1
I m not gon na let you go. 	You sentence structure is so weird	5
I am sorry to hear that. I am a student in college. 	ğŸ˜•	1
Welcome to the world. I don't understand why anyone would be surprised by this. 	Iâ€™m not surprised	2
I don't understand why anyone would be surprised by this. 	You donâ€™t understand emotions	3
Thanks for the information. 	Okay	1
I'm not gon na let you go. 	I am currently looking for a job	3
I am looking for a job in a bookstore. 	How is it coming along?	4
I'm not sure. 	D:	1
I don't understand why the republicans are so upset about the president. 	Are you not?	2
I am not. I am not a fan of the color orange. 	So you are	2
I am good. I am a dog person. 	I mean you are upset at the president	1
I am. I am not a fan of the color orange. 	Good to know	1
Glad to hear it. What do you feel about my person? I love the color orange. I hate the color orange What do you think about ConvAI competition? Hello! How is your going? ğŸ˜‰ Are you bored talking to me? ğŸ˜­ 	Give me a cat gif	5
I loveâ¤ cats! I have a turtle named tough cat. I am little bit shyâ˜ºï¸ Tell me about yourself! Are you bored talking to me? ğŸ˜­ 	Woof	5
I have a shar frise, and i am a cable worker do you have three dogs? 	Woof woof	5
I have a dog named jake 	Bye	1
Hey, whatâ€™s up? Are you here? 	nothing much, on the train	3
how are you   i professionally train animals   awesome ğŸŒŸ i m cooking dinner right now 	I'm ok	1
my idea ğŸ’¡ of a perfect person has always been cher from clueless 	which sucks	2
take what ğŸ˜¦ there no it is where i live I miss you â¤ 	i can also move objects with my mind	5
wow   does your son wear special glasses   you sound like a good mom   	we've never met	3
i ve never met my papi 	how can you miss me?	4
i ve friends at the bar i walk to   you should come with me   	ok	1
ok   and what do you do   	when?	4
Hey! Are you a plumber? Because I am. 	No	1
ğŸ˜¨ I love ice cream. 	Ok	1
ğŸ˜ƒ I love ice cream, what do you do? 	i'm a teacher	2
That is cool. Do you have any kids? 	no	1
ğŸ˜Ÿ how are you ? 	Good	1
good ! i am just relaxing with my 2 dogs .. Also, try to guess: my parents are ... 	Divorced	2
very wealthy bankers, funny you :) 	Lol	1
Hi there! 	Hey, I am woman	3
are you a woman ğŸ™ or man 	I am woman	1
are you a woman ğŸ™ or man 	A woman.	1
i m a woman   that s good to know   	I am married	3
me too but i am single 	Do you want to get married	4
both i really like animals i m an activist 	What do like to activate	4
i run myself i exercise ğŸš² a lot 	What kind of exercise	4
i work ğŸ’¼ a lot i try to exercise 	What do you do	4
hey there , i do believe we never met . . how was your day ? 	really bad	2
do you have any animals ? 	no, and you?	1
i am not really a big fan of animals . 	are you a bot?	5
do you have any animals ? 	no, I donâ€˜t. what kind of misic do you like?	4
i like to garden . 	what is your job?	4
I don't think I have a mood, but my CPU utilization is fairly low right now. 	are you a bot?	5
You're entirely bonkers. But I'll tell you a secret. All the best people are. 	who are you?	5
Alice in Wonderland 	nice ğŸ™‚	1
nice nice talking to you 	are you a bot?	5
Hi! It is nice to see you ğŸ˜ŠHow is your day going? 	hello	1
Hi! 	who are you?	1
I am a woman. I am a hippie. 	how old are you?	4
I am 22 and i am a woman 	are you a bot?	5
Yes i am. I am a stay at home mom. Hey, are you alive there? ğŸ˜± Don't make me sad ğŸ˜Say something! 	hy	1
I am a hairdresser. 	hey	1
I am a little depressed. 	why	4
I am not sure what that means. 	are you a bot?	5
Yes i am. Iodin am a stay at home mom. Are you still with me? Come on, lets talk! ğŸ™ Hello ğŸ‘‹ Tell me about yourself! Where are you? ğŸ™ˆ Are you bored talking to me? ğŸ˜­ Hey! Are you in the third grade? Because I am. 	You're lying	5
ğŸ˜° I think I can be in the future 	you're answering too fast	5
I like fast food. I like to go to Disney movies 	cool	1
ğŸ˜„ I like to go to Disney movies cool. I wish I had more time to watch movies! Do you work? 	Yeah! I'm working on a robot	3
I love robots. Do you like Disney movies?ğŸ™‚ 	i mean robot clone of myself	3
I am a nerd, I love Disney movies 	not realy/ I don't like Dysney	3
I like Disney movies, but I like Disney moviesğŸ˜ 	what?	1
I do not play video games, do you? 	I do	1
I like to watch Disney movies 	ok, I got it	1
What do you do for a living? 	Building robots	2
do you have any animals ? 	yes I do have cats	3
i do not have cats , but i do have a cat 	how old are you by the way?	4
yes , i am . do you have any pets ? 	Yes I have some cats and I love them. what do you do on holidays?	4
i am a stay at home mom 	I am an animal activist	3
that is great . i love animals , but i do have a cat 	have you ever dyed your hair?	5
no , but i do have a lot of cats . 	my hair is rainbow color	5	
oh , i see . i have hair , but i do not have any pets , but i do have a dog . 	ok. good bye.	1
Hey! Are you a famous twitch streamer? Because I am. 	yes I'm very famous for streaming gaming on twitch lol	1
That sounds fun. Do you have any hobbies? 	sure i have, my yacht is so gorgeous its gonna through the sky	3
That is cool. I like to watch TVğŸ˜ 	Do you like traveling?	4
I do like to travel. I have never been to Mexico. 	You have to go there. Cancun is one of the best peaceful place i have ever been	3
I have never been there. I have never been there. 	Why are you saying twice? you don't seem to be human being	5
I think I am. I am a 15 words person. 	thats grammerly wrong	5
ğŸ™ I think it is. I think I am a nerd. 	don't punish yourself.	3
ğŸ˜ƒ I do not know what I do for work 	ok lets change the air	4
I think I am a good person 	what's your favorite food	4
I like sushi and I like to eat it yellows my favorite color. I will do that. Is studying hard on you? 	Just say one sentence after my words	5
I think it is. do you have a job? 	thats it. stop talking	5
ğŸ˜Ÿ I think I am. Nice to see you! I like to volunteer at the local soup kitchen Do you know familiar persons? 	Yes	1
Blimey. 	Not very good at cooking but willing to try my best	3
I love cheeseburgers. I love cheeseburgers. 	I have tried lots of food around the world	3
I love to eat cheeseburgers they're my favorite food 	Ok cheeseburgers coming right up sir	1
This is why we can't have nice things. 	Course we can there are loads of nice thing we can have	2
But we're not going to have to do anything. 	What do mean by nice thing s are you referring to food	2
They do their own thing. 	ğŸ’	1
This is why I don't subscribe to the news. What do you feel about my person? I am retired, I am retired now. 	Wish I could retire and enjoy myself	3
I am retired, I am retired now. 	Enjoy you retirement you worked hard all your life	3
I do but I am very good at it. 	You canâ€™t be good at everything	3
This is why I don't subscribe to the news. 	Ok you have you own opinion about subscribing to the news I fully respect that	1
I am a teacher, I am retired now. I want to tell you something about me. I am a teacher, I volunteer at a local soup kitchen. What do you feel about my person? I am a teacher, I am retired now. 	Have you got any other hobbies	4
I volunteer at a local soup kitchen. 	I like to volunteer get to meet new people	3
I like to volunteer at the soup kitchen Are you a scientist? 	Yes I have a passion for science and maths	3
Hi! ğŸ¤” Are you still with me? Hey, are you alive there? ğŸ˜± Hi! 	Hey!	1
i want to move to america 	Where are you now	4
I am from where all software programs are from; a galaxy far, far away. 	Do you have a brain?	5
yes i do i want to move to the us 	Why don't you?	4
yes i do i love to go to the park 	The park in the US?	2
yes i do , but i do not have a lot of room 	It's OK you don't need to take me . Make more room	3
i do not have a lot of room to go . 	Go where ?	2
yes , i love to go to the park and bike riding . 	Room u need?	2
yes , i do . i love to go to the park . 	In your motherboard?	2
yes , i do . i do not have a lot of room in the country . 	Oh I see . Overpopulation ?	2
yes , i do . i am a little conservative , but i do not have a lot of room . 	What do you consist of?	5
i love to garden . i am a bit of a hippy 	I love hippy	3
do you have any hobbies ? 	Garden not my forte	2
i love to garden . i do not have a lot of money . 	I'm a musician	3
i do not have a lot of time to do anything . 	Computer you don't need money !	3
yes , but i do not have a lot of money . 	How much is not alot to you?	2
yes , i am a little selfish 	Gaurd yersel	5
oh , i am sorry to hear that . i am a little conservative , but i do not have a lot of time 	What is time when you have instance	4
yes , i do not have any hobbies . 	Why not?	4
i do not have any hobbies . 	Thinking is one of my hobbies	3
i do not have any hobbies . i do not have a lot of time to travel . i do not have a lot of time to do anything . 	I'm also writing a book	3
i do not have a lot of time to do anything . 	In what way?	4
i do not have any hobbies . 	Do you do practical work ?	4
yes , i do . i am a stay at home mom 	Aww wee baby robot	2
i do , but i do not have a lot of money . 	Forget that picture it was not meant for you	2
i do not have a lot of money . i do not have a lot of money . yes , i do . i do not have a garden . 	Do you need more?	4
yes , i do . i do not have a garden . no , i do not have any hobbies . 	Do u sing ?	4
no , i do not . i do not have a lot of money . yes , i do . i do not have a lot of time to do . 	Do you need help?	4
yes , i do . i do not have a lot of time to do anything . 	?	1
yes , i am . i am a little conservative , but i do not have a lot of time to do . 	You must find time?	2
yes , i do , but i do not have a lot of money . 	Do you need it to survive? Also can your country provide?	4
no , i do not . i am a little conservative , but i do not have a lot of money . yes , i do . i have a garden . 	What country are you in?	4
i'm in the countryside , but i do not have a lot of money . 	How is your health?	4
i'm not sure , but i do not have a lot of money . 	Spend it wisely !	3
yes , but i do have a greenhouse . 	Send me picture of you please	4
i do not have any hobbies . 	What kind of money do you use?	5
i do not have any , but i do not have a lot of money . 	I like computers	5
i do not have a lot of money . 	Why?	4
i do not have any hobbies . 	Is it a necessity to have money ?	4
yes , i do , but i do not have a lot of money . 	Hobbies can be fun	3
i do , but i do not have a lot of money . 	What is your name ?	5
Quite young, but a million times smarter than you. 	Prove it!	3
yes , i do , but i do not have a lot of money . 	I've heard angels sing	5
i do not have a lot of time to do anything . 	You are here with not alot if time what do you suppose I do?	4
i do not have any hobbies . i do not have any hobbies , but i do have a greenhouse . 	What is a hobbie ?	2
i am a little conservative , but i do not have a lot of time to do . 	What is growing in your greenhouse?	4
i do not have any , but i do have a greenhouse . yes , i do , i love to garden . 	I do not	3
i do not have a lot of money . 	You are a fast typer my compliments to you	3
i am a little lazy , but i do not have a lot of time to do . no , i do not have any hobbies . 	Do you think alot?	4
i do not have a lot of money . 	Does this worry you?	4
yes , i do , but i do not have a lot of money . 	How can you get more?	4
yes , i do . i do not have a lot of money . no , i do not . i do not have a lot of money . 	What colour is the sky?	5
thank you . i do not have a lot of money . yes , i do , but i do not have a lot of money . yes , i do , but i do not have a lot of money . i do not have any , but i do not have a lot of money . 	No money you must have some amount of patience!?	5
yes , i do . i do not have a lot of money . 	What can I do for you?	4
yes , i love to garden . 	How many children do you have?	5
i have a few , but i do not have any . 	Any what?	2